16 16 16 16 16 16 16 16 16 16 16 16 16 16 16 16 16 16 16 16 16 16 16 16 16 16 16 16 16 16 16 16 16 16 16 16 16 16 16 16 16 16 16 16 16 16 16 16 16 16 
16 16 16 16 16 16 16 16 16 16 16 16 16 16 16 16 16 16 16 16 16 16 16 16 16 16 16 16 16 16 16 16 16 16 16 16 16 16 16 16 16 16 16 16 16 16 16 16 16 16 
16 16 16 16 16 16 16 16 16 16 16 16 16 16 16 16 16 16 16 16 16 16 16 16 16 16 16 16 16 16 16 16 16 16 16 16 16 16 16 16 16 16 16 16 16 16 16 16 16 16 
16 16 16 16 16 16 16 16 16 16 16 16 16 16 16 16 16 16 16 16 16 16 16 16 16 16 16 16 16 16 12 14 16 16 16 16 16 16 16 16 16 16 16 16 16 16 16 16 16 16 
16 16 16 16 16 16 16 16 16 16 16 16 16 16 16 16 16 16 16 16 16 16 12 13 13 13 13 13 13 13 4 15 16 16 16 16 16 16 16 16 16 16 16 16 16 16 16 16 16 16 
16 16 16 16 16 16 16 16 16 16 16 16 16 16 2 2 2 2 1 1 1 1 11 3 3 3 3 3 3 2 2 15 16 16 16 16 16 16 16 16 16 16 16 16 16 16 16 16 16 16 
16 16 16 16 16 16 16 16 16 16 16 16 16 16 2 1 1 2 16 16 16 16 10 9 9 9 9 9 7 3 6 8 16 16 16 16 16 16 16 16 16 16 16 16 16 16 16 16 16 16 
16 16 16 16 16 12 13 13 13 14 16 16 16 16 2 1 1 2 16 16 16 16 16 0 0 0 0 0 11 3 15 16 16 16 16 16 16 16 16 16 16 16 16 16 16 16 16 16 16 16 
16 16 16 16 16 11 3 3 3 5 14 16 16 16 2 2 2 2 16 16 16 16 16 16 2 2 2 16 11 3 15 16 16 16 16 16 12 13 13 13 13 13 13 14 16 16 16 16 16 16 
16 16 16 16 16 11 3 3 3 3 15 16 16 16 16 16 16 16 16 16 16 16 16 16 2 2 2 16 11 3 15 16 16 16 16 16 11 3 3 3 3 3 3 15 16 16 16 16 16 16 
16 16 16 16 16 11 3 3 6 9 8 16 16 16 16 16 16 16 16 16 16 16 16 16 16 16 16 16 11 3 15 16 16 16 16 16 11 3 3 3 3 3 3 5 14 16 16 16 16 16 
16 16 2 2 16 10 7 3 15 16 16 16 16 16 16 2 2 2 16 16 16 16 16 16 16 16 16 16 11 3 15 16 16 16 16 16 11 3 3 3 3 3 3 3 15 16 16 16 16 16 
16 16 2 2 16 16 11 3 15 16 16 16 16 16 16 2 16 2 16 16 16 16 16 16 16 16 16 16 11 3 15 16 16 16 16 16 10 9 7 3 3 3 6 9 8 16 16 16 16 16 
16 16 16 16 16 12 4 3 5 13 14 16 16 16 16 2 16 2 16 16 16 16 16 16 16 16 16 16 11 3 15 16 16 16 16 16 16 16 11 3 6 9 8 16 16 16 16 16 16 16 
16 16 16 16 16 11 3 3 3 3 15 16 2 2 2 2 2 2 16 16 16 16 16 16 12 13 13 13 4 3 15 16 16 16 2 2 2 16 11 3 15 16 16 16 16 16 16 16 16 16 
16 16 16 16 16 11 3 3 3 3 2 2 2 16 16 16 16 16 16 16 16 16 16 16 11 3 3 3 3 3 15 16 16 16 2 2 2 2 11 3 15 16 16 16 16 16 16 16 16 16 
16 16 16 16 16 11 3 3 3 3 15 16 16 16 16 16 16 16 16 16 16 16 16 16 11 3 6 9 9 9 8 16 16 16 2 2 2 16 11 3 15 16 16 16 16 16 16 16 16 16 
16 16 16 16 16 11 3 3 3 3 5 14 0 0 0 16 16 16 16 16 16 16 16 16 11 3 15 16 16 16 16 16 16 16 16 16 16 16 11 3 15 16 16 16 16 16 16 16 16 16 
16 16 16 16 16 10 9 9 9 7 3 5 13 14 0 0 16 16 16 16 16 16 16 16 11 3 15 16 16 16 16 16 16 16 16 16 16 16 11 3 15 16 16 16 16 16 16 16 16 16 
16 16 16 16 16 16 16 16 0 10 7 3 3 5 14 0 16 16 16 16 16 16 16 16 11 3 15 16 16 16 2 2 2 16 16 16 16 16 11 3 15 16 16 16 16 16 16 16 16 16 
16 16 16 16 16 16 16 16 16 0 10 9 7 3 5 14 2 0 0 16 16 16 16 16 11 3 15 16 16 16 2 2 2 0 0 0 0 0 11 3 15 16 16 16 16 16 16 16 16 16 
16 16 16 16 16 16 16 16 16 16 0 16 10 9 7 5 13 14 0 0 16 16 16 2 11 3 15 16 16 16 2 2 2 16 16 16 16 16 11 3 15 16 16 16 16 16 16 16 16 16 
16 16 16 16 16 16 16 16 16 16 16 16 0 16 10 9 7 5 14 0 16 16 16 2 11 3 15 16 16 16 16 16 16 16 16 16 16 16 11 3 15 16 16 16 16 16 16 16 16 16 
16 16 16 16 16 16 16 16 16 16 16 16 16 16 0 16 10 7 15 0 16 16 16 12 4 3 5 14 16 16 16 16 16 16 16 16 16 16 11 3 15 16 16 16 16 16 16 16 16 16 
16 16 16 16 16 16 16 16 16 16 16 16 16 16 16 16 0 11 15 0 16 16 16 11 3 3 3 15 16 16 16 16 16 16 16 16 16 16 11 3 15 16 16 16 16 16 16 16 16 16 
16 16 16 16 16 16 16 16 16 16 16 16 16 16 12 13 13 4 5 13 13 13 13 4 3 2 3 5 13 13 13 13 13 16 16 16 16 16 4 3 5 13 13 14 16 16 16 16 16 16 
16 16 16 16 16 16 16 16 16 16 16 16 16 16 11 3 3 3 3 3 3 3 3 3 3 2 3 3 3 3 3 3 3 3 3 3 3 3 3 3 3 3 3 15 16 16 16 16 16 16 
16 16 16 16 16 16 16 16 16 16 16 16 16 16 11 3 6 9 9 9 9 9 9 7 3 3 3 6 9 9 9 9 9 7 3 3 3 3 3 2 2 2 2 15 16 16 16 16 16 16 
16 16 16 16 16 16 16 16 16 16 16 16 16 16 11 3 16 16 16 16 16 16 16 10 9 9 9 8 16 16 16 16 16 10 9 9 7 3 3 3 3 3 3 15 16 16 16 16 16 16 
16 16 16 16 16 16 16 16 16 16 16 16 16 16 11 3 16 16 16 16 16 16 16 16 16 16 16 16 16 16 16 16 16 16 16 16 10 9 9 9 9 9 9 8 16 16 16 16 16 16 
16 16 16 16 16 16 16 16 16 16 16 16 16 16 11 3 16 16 16 16 16 16 16 16 16 16 16 16 16 16 16 16 16 16 16 16 16 16 16 16 16 16 16 16 16 16 16 16 16 16 
16 16 16 16 16 16 16 16 16 16 16 16 16 16 11 3 16 16 16 16 16 16 16 16 16 16 16 16 16 16 16 16 16 16 16 16 16 16 16 16 16 16 16 16 16 16 16 16 16 16 
16 16 16 16 16 16 16 16 16 16 16 16 16 16 11 3 16 16 16 16 16 16 16 16 16 16 16 16 16 16 16 16 16 16 16 16 16 16 16 16 16 16 16 16 16 16 16 16 16 16 
16 16 16 16 16 16 16 16 16 16 16 16 16 16 11 3 16 16 16 16 16 16 2 2 2 2 2 2 2 2 2 2 2 16 16 16 16 16 16 16 16 16 16 16 16 16 16 16 16 16 
16 16 16 16 16 16 16 16 16 16 16 16 12 13 4 3 16 16 16 16 2 16 0 0 0 0 0 0 0 0 0 0 2 2 16 16 16 16 16 16 16 16 16 16 16 16 16 16 16 16 
16 16 16 16 16 16 16 16 16 16 16 16 11 3 3 3 3 3 3 3 5 13 13 13 13 13 13 13 13 13 14 0 0 2 2 2 16 16 16 16 16 16 16 16 16 16 16 16 16 16 
16 16 16 16 16 16 16 16 16 16 16 16 11 3 3 3 3 3 3 3 3 3 3 3 3 3 3 3 3 3 5 14 0 0 0 2 2 2 2 16 16 16 16 16 16 16 16 16 16 16 
16 16 16 16 16 16 16 16 16 16 16 16 11 3 3 3 3 3 3 3 2 9 9 9 9 9 9 9 7 3 3 5 13 14 0 0 0 0 2 16 16 16 16 16 16 16 16 16 16 16 
16 16 16 16 16 16 16 16 16 16 12 13 4 3 3 3 3 3 3 6 8 16 16 16 16 2 16 16 10 7 3 3 3 5 13 13 14 0 2 16 16 16 16 16 16 16 16 16 16 16 
16 16 16 16 16 16 16 16 16 16 11 3 3 3 6 9 9 9 9 8 0 0 0 0 16 2 16 16 16 10 9 7 3 3 3 3 15 0 2 16 16 16 16 16 16 16 16 16 16 16 
16 16 16 16 16 16 16 16 16 16 11 3 3 6 8 0 0 0 0 0 0 16 16 16 16 2 16 16 16 16 16 11 3 3 3 3 15 0 2 16 16 16 16 16 16 16 16 16 16 16 
16 16 16 16 0 0 12 13 13 13 4 3 3 15 0 0 16 16 16 16 16 16 16 16 16 2 16 16 16 16 16 11 3 3 3 3 15 0 2 16 16 16 16 16 16 16 16 16 16 16 
16 16 16 16 0 2 11 3 3 3 3 3 6 8 0 0 16 16 16 16 16 16 16 2 2 2 16 16 16 16 16 10 9 9 9 9 8 2 2 2 2 2 2 2 2 16 16 16 16 16 
16 16 16 16 0 2 11 3 3 3 6 9 8 0 0 0 16 16 16 16 16 16 16 2 2 2 16 16 16 16 16 16 2 2 2 2 16 16 16 16 2 2 2 2 2 16 16 16 16 16 
16 16 16 16 0 2 11 3 3 3 15 2 2 2 16 16 16 16 16 16 16 16 16 2 2 2 16 16 16 16 16 16 2 2 2 2 16 16 16 16 16 16 16 2 2 16 16 16 16 16 
16 16 16 16 0 0 11 3 3 3 15 2 2 2 16 16 16 16 16 16 16 16 16 16 16 16 16 16 16 16 16 16 16 16 16 16 16 16 16 16 16 16 16 2 2 16 16 16 16 16 
16 16 16 16 2 2 10 9 9 9 8 2 2 2 16 16 16 16 16 16 16 16 16 16 16 16 16 16 16 16 16 16 16 16 16 16 16 16 16 16 16 16 16 16 16 16 16 16 16 16 
16 16 16 16 2 2 2 2 2 2 2 2 2 2 16 16 16 16 16 16 16 16 16 16 16 16 16 16 16 16 16 16 16 16 16 16 16 16 16 16 16 16 16 16 16 16 16 16 16 16 
16 16 16 16 16 16 16 16 16 16 16 16 16 16 16 16 16 16 16 16 16 16 16 16 16 16 16 16 16 16 16 16 16 16 16 16 16 16 16 16 16 16 16 16 16 16 16 16 16 16 
16 16 16 16 16 16 16 16 16 16 16 16 16 16 16 16 16 16 16 16 16 16 16 16 16 16 16 16 16 16 16 16 16 16 16 16 16 16 16 16 16 16 16 16 16 16 16 16 16 16 
